ALFM   -   ALFALFA (MEAN)*
ALFN   -   ALFALFA (NEW PLANT)
ALFP   -   ALFALFA (PEAK)*
APPL   -   APPLES
ASPA   -   ASPARAGUS
BEAN   -   DRY BEANS
BEET   -   SUGAR BEETS
BLGR   -   BLUEGRASS SEED
BLUB   -   BLUEBERRIES
BROC   -   BROCCOLI
CABG   -   CABBAGE
CGRP   -   CONCORD GRAPES
CHRY   -   CHERRIES
CRAN   -   CRANBERRIES
CRTS   -   CARROT SEED
FCRN   -   FIELD CORN
GARL   -   GARLIC
GRSD   -   GRASS SEED
HAYP   -   FESCUE GRASS HAY (PEAK DAILY CONSUMPTIVE USE FOR MATURE GRASS HAY)
HAYM   -   FESCUE GRASS HAY (MEAN ANNUAL USE WITH 3 SEASONAL CUTTINGS)
HOPS   -   HOPS
LAWN   -   LAWN
LILY   -   EASTER LILIES
MELN   -   MELONS
NMNT   -   NEW MINT
ONYN   -   ONION
ORCH   -   ORCHARDS
PAST   -   PASTURE
PEAR   -   PEARS
PEAS   -   PEAS
PECH   -   PEACHES
POP1   -   FIRST YEAR POPLAR TREES
POP2   -   SECOND YEAR POPLAR TREES
POP3   -   THIRD YEAR + POPLAR TREES
POTA   -   POTATOES
POTS   -   POTATOES (SHEPODY)
PPMT   -   PEPPERMINT
RAPE   -   RAPESEED (CANOLA)
SAFL   -   SAFFLOWER
SPMT   -   SPEARMINT
SBAR   -   SPRING BARLEY
SBRY   -   STRAWBERRY
SCRN   -   SWEET CORN
SGRN   -   SPRING GRAIN
SPMT   -   SPEARMINT
TBER   -   TRAILING BERRIES
WGRN   -   WINTER GRAIN
WGRP   -   WINE GRAPE